#############################
#   #                  #    #
#         #            # ####
#                   ###     #
#   #     #      #          #
#               #     #     #
#                           #
#   #     #     #           #
#                    #      #
#####                       #
#                   #       #
#   #       #               #
#############################

